Equipo,PJ,PG,PE,PP,GF,GC,DG,SN,PT
VALDELOSA FS,7,4,1,2,36,27,9,0,13
DOÑINOS-LOW COST CARBURANTES,7,3,4,0,35,28,7,0,13
BIZAS,6,4,0,2,34,22,12,0,12
LIVERPOOL PUB,7,4,0,3,31,20,11,0,12
PAPELERIA SAN FERNANDO B,6,3,2,1,26,16,10,0,11
UNIÓN VINOTINTO FS,6,3,2,1,21,17,4,0,11
TRIANGLE CREATIVE-BAR VERDI,6,3,1,2,31,23,8,0,10
LA ROSA IBÉRICA,6,2,1,3,35,51,-16,0,7
CASTELLANOS DE MORISCOS,6,2,1,3,10,20,-10,0,6
DOÑINOS FS,6,1,0,5,23,36,-13,0,3
FC HIDRAFRESA SONNER,7,0,1,6,24,46,-22,0,1
