Equipo,PJ,PG,PE,PP,GF,GC,DG,SN,PT
PAPELERIA SAN FERNANDO B,8,5,2,1,33,18,15,0,17
LIVERPOOL PUB,9,5,1,3,44,28,16,0,16
BIZAS,8,5,1,2,50,35,15,0,16
DOÑINOS-LOW COST CARBURANTES,9,3,6,0,43,36,7,0,15
VALDELOSA FS,8,4,2,2,47,38,9,0,14
CASTELLANOS DE MORISCOS,8,4,0,4,27,29,-2,0,12
UNIÓN VINOTINTO FS,8,3,2,3,26,26,0,0,11
TRIANGLE CREATIVE-BAR VERDI,8,3,1,4,34,31,3,0,10
LA ROSA IBÉRICA,8,2,1,5,42,67,-25,0,7
DOÑINOS FS,8,2,0,6,34,50,-16,0,6
FC HIDRAFRESA SONNER,8,0,2,6,28,50,-22,0,2